■■■■■■■■■■■■
■　　　　　　　　　　■
■　　■■■■■■　　■
■　　　　■　　　　　■
■　　　　■　　　　　■
■　　　　　■　　　　■
■　　　　　　　　　　■
■　　■■■■■■　　■
■　　　　■　　　　　■
■　　　　　　■■　　■
■■■■■■■■■■■■
