■■■■■■■■■■■■■■■■■■■■■■
■　　　　　　　　　　　　　　　　　　　　■
■　　　　　　　　　　　　　　　　　　　　■
■　　　　■　　　　　　■■■■■■　　　■
■　　　　■　　　　　　　　　　　　　　　■
■　　　　　　　　　　　　　　　　　　　　■
■　　　　　　　　　　　　　　　　　　　　■
■　　　■■■■■　　　　　　■■　　　　■
■　　　　　　　　　　　　　　　　　　　　■
■　　　　　　　　　　　　　　　　　　　　■
■　　　　　　　　　　　　　　　　　　　　■
■　　　■■■■■　　　　　　■■　　　　■
■　　　　　　　　　　　　　　　　　　　　■
■　　　　　　　　　　　　　　　　　　　　■
■■■■■■■■■■■■■■■■■■■■■■