■■■■■■■■■■■■■■■■■■■■■■■■■■■■■■■■■■■■
■　　　　　　　　　　　　　　　■　　■　　　　　　　　　　　　　　　■
■　　　　　　　　　　　　　　　■　　■　　　　　　　　　　　　　　　■
■　　　　　　　　　　　　　　　■　　■　　　　　　　　　　　　　　　■
■　　　　　　　　　　　　　　　　　　　　　　　　　　　　　　　　　　■
■　　　　　　　　■■■■■　　　　　　　　■■■■■　　　　　　　　■
■　　■■　　　　■　　　　　　　　　　　　　　　　■　　　　■■　　■
■　　　■　　　　■　　　　　　　　　　　　　　　　■　　　　■　　　■
■　　　■　　　　■　　　　　　　　　　　　　　　　■　　　　■　　　■
■　　　■　　　　■　　　　　　　　　　　　　　　　■　　　　■　　　■
■　　　■　　　　■　　　　　　■　　■　　　　　　■　　　　■　　　■
■　　　■　　　　　　　　　■■■　　■■■　　　　　　　　　■　　　■
■　　　■　　　　　　　　　　　　　　　　　　　　　　　　　　■　　　■
■　　　■　　　　　　　　　　　　　　　　　　　　　　　　　　■　　　■
■　　　■　　　　　　　　　■■■　　■■■　　　　　　　　　■　　　■
■　　　■　　　　■　　　　　　■　　■　　　　　　■　　　　■　　　■
■　　　■　　　　■　　　　　　　　　　　　　　　　■　　　　■　　　■
■　　　■　　　　■　　　　　　　　　　　　　　　　■　　　　■　　　■
■　　　■　　　　■　　　　　　　　　　　　　　　　■　　　　■　　　■
■　　■■　　　　■　　　　　　　　　　　　　　　　■　　　　■■　　■
■　　　　　　　　■■■■■　　　　　　　　■■■■■　　　　　　　　■
■　　　　　　　　　　　　　　　　　　　　　　　　　　　　　　　　　　■
■　　　　　　　　　　　　　　　■　　■　　　　　　　　　　　　　　　■
■　　　　　　　　　　　　　　　■　　■　　　　　　　　　　　　　　　■
■　　　　　　　　　　　　　　　■　　■　　　　　　　　　　　　　　　■
■■■■■■■■■■■■■■■■■■■■■■■■■■■■■■■■■■■■
